Introduction	はじめに	
Chapter Overview	章の概要	（日本語の基礎知識・文字）
Hiragana	ひらがな	
Hiragana Practice Exercises	ひらがな練習問題	
Katakana	カタカナ	
Katakana Practice Exercises	カタカナ練習問題	
Kanji	漢字	
Chapter Overview	章の概要	（基本的な構文）
Expressing state-of-being	状態説明	だ、じゃない
State-of-being Practice Exercises	状態説明練習問題	
Introduction to Particles	助詞(格助詞)	は、も、が
Particle Practice Exercises	助詞(格助詞)の練習問題	
Adjectives	形容詞	
Adjective Practice Exercises	形容詞練習問題	
Verb Basics	動詞の基本	
Verb Practice Exercises	動詞の基本練習問題	
Negative Verbs	動詞の否定	
Negative Verb Practice Exercises	動詞の否定練習問題	
Past Tense	動詞の過去形	
Past Verb Practice Exercises	動詞の過去形の実践演習	
Particles used with verbs	動詞と助詞(接続助詞・副助詞)	を、に、へ、で
Transitive and Intransitive Verbs	推移と自動詞	
Relative Clauses and Sentence Order	関係節と文の順序	
Noun-related Particles	名詞と助詞(接続助詞・副助詞)	と、や、とか、の
Adverbs and Sentence-ending particles	副詞と終助詞	
Chapter Overview	章の概要	（文法の基本）
Polite Form and Verb Stems	丁寧な表現・敬語	です、ます
Addressing People	人の呼称・人称	
The Question Marker	疑問	か？
Compound Sentences	複雑な文(て-型) 	て-型、から、ので、のに、が、けど、し、たりする
Other uses of the te-form	て-型その他	"ている、てある、て
おく、ていく、てくる"
Potential Form	可能	られる、できる
Using する and なる with the に particle	助詞「に」と「する」「なる」	[よう]になる／する
Conditionals	条件	と、なら、ば、たら
Expressing ;must; or ;have to	禁止、義務、許可	だめ、いけない、ならない、ても
Desire and Suggestions	希望、意思、意向、提案	たい、欲しい、[意思]、たらどう
Acting on relative clauses [Performing an action on a relative clause]	関係節(伝聞・引用)	と、って
Defining and Describing	定義・説明	という
Trying or attempting something	試行、意思と動詞	てみる、[意思。しよう]+ とする
Giving and Receiving	授与・授受・代理	"あげる、やる、くれる、もらう
Making Requests	要求・命令	"ください、ちょうだい、なさい、命令形"
Numbers and Counting	数の数え方・単位	ひとつ、ひとり、ついたち
Casual Patterns and Slang	日常会話表現と俗語	なんじゃない、なんで？
Review and more sentence-ending particles	まとめと他の終助詞	さらなる日常会話表現と俗語
Chapter Overview	章の概要	（基本的で具体的な表現）
Causative and Passive Verbs	原因と受動動詞	
Honorific and Humble Forms	敬語(尊敬)と謙譲	おっしゃる、申す
Unintended Actions	想定外の表現	てしまう、ちゃう／じゃう
Special Expressions with Generic Nouns	名詞的表現	こと、ところ、もの
Various degrees of certainty	推察・予想	かもしれない、でしょう、だろう
Expressing Amounts	量や程度の表現	"だけ、のみ、しか、ばかり、すぎる、[量]+ も、ほど、さ"
Similarity or hearsay	類似と伝聞	よう、みたい、そう、そうだ、らしい、っぽい
Using 「方」 and 「よる」	「方」と「よる」(比較・選択)	より、の⽅、[動詞]＋⽅、によって、によると
Actions that are easy or hard to do	難易	Vやすい、Vにくい
More negative verbs	様々な否定動詞表現	ないで、ず、ん、ぬ
Hypothesizing and Concluding	仮定と結論	わけ、とする
Time-specific actions	時制を伴う品詞	ばかり、とたんに、ながら、まくる
Expressing a lack of change	継続・放置	まま、っぱなし
Chapter Overview	章の概要	（応用表現）
Formal Expressions	形式ばった・文章表現	である、ではない
Things that should be a certain way	妥当、義務、当然、禁止、	はず、べき、べく、べからず
The minimum expectation	期待限定、例外、	でさえ、ですら、おろか
Showing signs of something	（意向）態度、兆候	がる、ばかり、めく
Expressing non-feasibility	非意図的表現	ざるを得ない、やむを得ない、かねる
Tendencies	傾向・継続状態	がち、つつ、きらいがある
Advanced Volitional	意思・意向表現、不可能未来	まい、であろう、かろう
Covered by something	「多数」の表現	だらけ、まみれ、ずくめ
Immediate Events[Advanced proximity of actions]	「すぐに」の表現	が早いか、や否や、そばから
Other Grammar	その他、転換、同時、結果等の表現	思いきや、がてら、あげく
